###############
#.............#
#.#.#.#.#.#.###
#.............#
#,#,#.#.#,#,#.#
#,@,.....,%,..#
#,#,#.#.#,#,#.#
#.............#
#.#.#.#.#.#.#.#
#.............#
#.#.#.#.#.#.#.#
#.............#
###############